xxxxxxxxxx
x p x  o x
x   x    x
xx xx    x
xx x xxx x
xxox   x x
xx xx  x x
x   xxxx x
x        x
xo  xxxx x 
xx xx  x x
xx xx  xox
xx xxxxxxx
x     x
x     x
x o o x
x     x
xxxxxxx